a	a
abita	a b i t a
aeregh	a e r e g h
aeregha	a e r e g h a
aeroport	a e r o p o r t
aeroporta	a e r o p o r t a
afecjuna	a f e c j u n a
aha	a h a
ajar	a j a r
aje	a j e
ajeka	a j e k a
alberg	a l b e r g
almen	a l m e n
alor	a l o r
alora	a l o r a
amerikan	a m e r i k a n
an	a n
andz	a n d z
apošt	a p o š t
arkordam	a r k o r d a m
arkordaša	a r k o r d a š a
arkordat	a r k o r d a t
artira	a r t i r a
artirivahma	a r t i r i v a h m a
aš	a š
autobus	a u t o b u s
baliže	b a l i ž e
balun	b a l u n
balunič	b a l u n i č
baluniča	b a l u n i č a
bane	b a n e
banu	b a n u
baratol	b a r a t o l
baštunam	b a š t u n a m
baštunič	b a š t u n i č
baundze	b a u n d z e
bažija	b a ž i j a
bek	b e k
benja	b e n j a
ber	b e r
berahu	b e r a h u
bi	b i
bihma	b i h m a
bihu	b i h u
bija	b i j a
bijal	b i j a l
bijami	b i j a m i
bijasa	b i j a s a
bijat	b i j a t
bijiva	b i j i v a
bijivama	b i j i v a m a
bil	b i l
bila	b i l a
bile	b i l e
biša	b i š a
bit	b i t
bita	b i t a
bitahu	b i t a h u
bitam	b i t a m
bitat	b i t a t
biža	b i ž a
bižaša	b i ž a š a
bižu	b i ž u
blaga	b l a g a
bog	b o g
bogom	b o g o m
bolahu	b o l a h u
bolaša	b o l a š a
bolje	b o l j e
boma	b o m a
bome	b o m e
bonifač	b o n i f a č
bonifacio	b o n i f a c i o
bonoču	b o n o č u
bote	b o t e
botu	b o t u
bra	b r a
brat	b r a t
brda	b r d a
brdam	b r d a m
brehac	b r e h a c
bretagna	b r e t a g n a
breu	b r e u
brižan	b r i ž a n
brižna	b r i ž n a
brnjiva	b r n j i v a
bučena	b u č e n a
buda	b u d a
budi	b u d i
bughatu	b u g h a t u
bumbardivat	b u m b a r d i v a t
burgu	b u r g u
buritana	b u r i t a n a
butilja	b u t i l j a
butilje	b u t i l j e
butilju	b u t i l j u
cappuccetto	c a p p u c c e t t o
čaš	č a š
čeka	č e k a
čekal	č e k a l
čekala	č e k a l a
čekam	č e k a m
čeljada	č e l j a d a
čeljade	č e l j a d e
čeljadi	č e l j a d i
cerne	c e r n e
čèrv	č è r v
četar	č e t a r
che	c h e
ci	c i
či	č i
cija	c i j a
čija	č i j a
čil	č i l
cila	c i l a
čila	č i l a
čin	č i n
činahu	č i n a h u
činaša	č i n a š a
čindžun	č i n d ž u n
čingvand	č i n g v a n d
čini	č i n i
činim	č i n i m
činima	č i n i m a
činiš	č i n i š
činjiva	č i n j i v a
činjivat	č i n j i v a t
čit	č i t
cond	c o n d
contrada	c o n t r a d a
crne	c r n e
crnjela	c r n j e l a
ču	č u
čuda	č u d a
čuja	č u j a
čujahma	č u j a h m a
čujahu	č u j a h u
čujam	č u j a m
čujama	č u j a m a
čujaš	č u j a š
čujaša	č u j a š a
čuje	č u j e
čuju	č u j u
cukar	c u k a r
cukra	c u k r a
čul	č u l
čula	č u l a
čuminere	č u m i n e r e
cupahu	c u p a h u
cupija	c u p i j a
čuva	č u v a
čuvata	č u v a t a
d	d
da	d a
dajam	d a j a m
dajaša	d a j a š a
daju	d a j u
dal	d a l
dala	d a l a
dami	d a m i
dan	d a n
dana	d a n a
danas	d a n a s
dani	d a n i
daždaša	d a ž d a š a
de	d e
dëlafrandža	d ë l a f r a n d ž a
dëlidijač	d ë l i d i j a č
della	d e l l a
delo	d e l o
dëlukwarandatre	d ë l u k w a r a n d a t r e
denderu	d e n d e r u
desa	d e s a
despata	d e s p a t a
destinazion	d e s t i n a z i o n
devertil	d e v e r t i l
devertit	d e v e r t i t
dezgracja	d e z g r a c j a
di	d i
dič	d i č
dica	d i c a
dičalj	d i č a l j
dičalje	d i č a l j e
dicami	d i c a m i
did	d i d
dita	d i t a
dite	d i t e
diteta	d i t e t a
divendivaju	d i v e n d i v a j u
divojka	d i v o j k a
dizgracja	d i z g r a c j a
do	d o
dobra	d o b r a
dobri	d o b r i
dojaša	d o j a š a
dol	d o l
dola	d o l a
dolur	d o l u r
doma	d o m a
domislija	d o m i s l i j a
domislit	d o m i s l i t
dòp	d ò p
dòpka	d ò p k a
doša	d o š a
drita	d r i t a
druga	d r u g a
druge	d r u g e
drugi	d r u g i
drugihi	d r u g i h i
drugimi	d r u g i m i
drugo	d r u g o
drugu	d r u g u
držahu	d r ž a h u
držal	d r ž a l
dub	d u b
dubata	d u b a t a
dubrave	d u b r a v e
dubravu	d u b r a v u
dugine	d u g i n e
dunat	d u n a t
dunatina	d u n a t i n a
dva	d v a
dvahi	d v a h i
dvi	d v i
dviga	d v i g a
dvižaša	d v i ž a š a
dža	d ž a
džal	d ž a l
džardin	d ž a r d i n
džir	d ž i r
džirivahu	d ž i r i v a h u
džirivaju	d ž i r i v a j u
džirivam	d ž i r i v a m
džirivaša	d ž i r i v a š a
dzonu	d z o n u
dzukerjeru	d z u k e r j e r u
džumendat	d ž u m e n d a t
džuvan	d ž u v a n
dә	d ә
e	e
è	è
eš	e š
esembj	e s e m b j
extra	e x t r a
faceva	f a c e v a
fačil	f a č i l
falkun	f a l k u n
falkuna	f a l k u n a
familja	f a m i l j a
fandazma	f a n d a z m a
farl	f a r l
faše	f a š e
faštidj	f a š t i d j
fat	f a t
fata	f a t a
femina	f e m i n a
ferju	f e r j u
ferma	f e r m a
fermat	f e r m a t
fermi	f e r m i
fermivama	f e r m i v a m a
fermu	f e r m u
fešte	f e š t e
feštu	f e š t u
fidaša	f i d a š a
filibèrt	f i l i b è r t
fina	f i n a
finu	f i n u
fiškulija	f i š k u l i j a
fiškulijaju	f i š k u l i j a j u
fitat	f i t a t
forcom	f o r c o m
fortuna	f o r t u n a
fortunan	f o r t u n a n
fortunu	f o r t u n u
francia	f r a n c i a
frijana	f r i j a n a
frijane	f r i j a n e
frijija	f r i j i j a
fritatu	f r i t a t u
frond	f r o n d
fršalu	f r š a l u
frunda	f r u n d a
fule	f u l e
fulmin	f u l m i n
fulmina	f u l m i n a
fulminan	f u l m i n a n
funaštra	f u n a š t r a
funaštre	f u n a š t r e
furb	f u r b
furla	f u r l a
furnija	f u r n i j a
furnjiva	f u r n j i v a
furnjivaš	f u r n j i v a š
furt	f u r t
ga	g a
gallina	g a l l i n a
garme	g a r m e
gavuta	g a v u t a
gavute	g a v u t e
gavutu	g a v u t u
giro	g i r o
glad	g l a d
glada	g l a d a
glava	g l a v a
glave	g l a v e
glavu	g l a v u
gleda	g l e d a
gledahu	g l e d a h u
gledaju	g l e d a j u
gledala	g l e d a l a
gledaša	g l e d a š a
gledat	g l e d a t
godišt	g o d i š t
gor	g o r
goraša	g o r a š a
gorit	g o r i t
gorivam	g o r i v a m
gorivama	g o r i v a m a
gorivaš	g o r i v a š
gorivaša	g o r i v a š a
gošta	g o š t a
gošti	g o š t i
govaram	g o v a r a m
govaraša	g o v a r a š a
govare	g o v a r e
govoraša	g o v o r a š a
gozja	g o z j a
grad	g r a d
grada	g r a d a
gradu	g r a d u
grata	g r a t a
gre	g r e
greda	g r e d a
gredahma	g r e d a h m a
gredahu	g r e d a h u
gredama	g r e d a m a
gredaša	g r e d a š a
gredu	g r e d u
greš	g r e š
grini	g r i n i
grla	g r l a
grozja	g r o z j a
grozlja	g r o z l j a
gruba	g r u b a
gulaša	g u l a š a
guscu	g u s c u
gvaja	g v a j a
gvera	g v e r a
gvere	g v e r e
gveru	g v e r u
gvidivaša	g v i d i v a š a
halj	h a l j
halje	h a l j e
halju	h a l j u
hi	h i
hitahu	h i t a h u
hitaš	h i t a š
hitil	h i t i l
hitit	h i t i t
hiža	h i ž a
hiže	h i ž e
hižu	h i ž u
ho	h o
hočahu	h o č a h u
hočam	h o č a m
hočama	h o č a m a
hočaš	h o č a š
hočaša	h o č a š a
hočata	h o č a t a
hoče	h o č e
hodahma	h o d a h m a
hodija	h o d i j a
homa	h o m a
hot	h o t
hrani	h r a n i
hranit	h r a n i t
hranjan	h r a n j a n
hranjane	h r a n j a n e
hranjivahu	h r a n j i v a h u
hvaštun	h v a š t u n
in	i n
inglez	i n g l e z
italia	i t a l i a
italjan	i t a l j a n
ja	j a
jaja	j a j a
jake	j a k e
jam	j a m
jamil	j a m i l
jamila	j a m i l a
jamivam	j a m i v a m
jamivaš	j a m i v a š
jamjaš	j a m j a š
jasli	j a s l i
je	j e
jena	j e n a
jene	j e n e
jenga	j e n g a
jenu	j e n u
jesa	j e s a
jesi	j e s i
jesma	j e s m a
jesu	j e s u
jidahma	j i d a h m a
jidaxu	j i d a x u
jidu	j i d u
jijahma	j i j a h m a
jil	j i l
jim	j i m
jima	j i m a
jimahma	j i m a h m a
jimahu	j i m a h u
jimaju	j i m a j u
jimal	j i m a l
jimala	j i m a l a
jimama	j i m a m a
jiman	j i m a n
jimaš	j i m a š
jimaša	j i m a š a
jimat	j i m a t
jimbortiva	j i m b o r t i v a
jimbrezu	j i m b r e z u
jimival	j i m i v a l
jindiric	j i n d i r i c
jindzom	j i n d z o m
jindzoma	j i n d z o m a
jinsom	j i n s o m
jinveč	j i n v e č
jišča	j i š č a
jiščat	j i š č a t
jiska	j i s k a
jiška	j i š k a
jiškahu	j i š k a h u
jiskaju	j i s k a j u
jiškaju	j i š k a j u
jiskat	j i s k a t
jiskoda	j i s k o d a
jiskodahu	j i s k o d a h u
jiskodi	j i s k o d i
jiskodija	j i s k o d i j a
jiskodil	j i s k o d i l
jiskodila	j i s k o d i l a
jiskodit	j i s k o d i t
jist	j i s t
jistru	j i s t r u
jizbane	j i z b a n e
jizija	j i z i j a
jizist	j i z i s t
jo	j o
jokaju	j o k a j u
jomen	j o m e n
jopa	j o p a
još	j o š
ju	j u
juorn	j u o r n
jušt	j u š t
ka	k a
kačatur	k a č a t u r
kada	k a d a
kaka	k a k a
kalaša	k a l a š a
kalmal	k a l m a l
kam	k a m
kamb	k a m b
kamba	k a m b a
kana	k a n a
kandaša	k a n d a š a
kanduna	k a n d u n a
kanja	k a n j a
kapač	k a p a č
kapaša	k a p a š a
kapija	k a p i j a
kapikuola	k a p i k u o l a
kapila	k a p i l a
kapit	k a p i t
kapučeto	k a p u č e t o
karbunira	k a r b u n i r a
karbunire	k a r b u n i r e
karte	k a r t e
kartuna	k a r t u n a
kaša	k a š a
kaše	k a š e
kašteluč	k a š t e l u č
kašteluča	k a š t e l u č a
kazata	k a z a t a
ke	k e
keja	k e j a
ki	k i
kisa	k i s a
kjace	k j a c e
kjikjarija	k j i k j a r i j a
kjikjarijahu	k j i k j a r i j a h u
kjikjarijaj	k j i k j a r i j a j
kjikjarijal	k j i k j a r i j a l
ko	k o
kobasca	k o b a s c a
kobasce	k o b a s c e
kobile	k o b i l e
kobilu	k o b i l u
koja	k o j a
koje	k o j e
koji	k o j i
koju	k o j u
kokodi	k o k o d i
kokoša	k o k o š a
kokoše	k o k o š e
kokošu	k o k o š u
koljija	k o l j i j a
kolpi	k o l p i
komung	k o m u n g
kondadina	k o n d a d i n a
kondendzan	k o n d e n d z a n
kondravelena	k o n d r a v e l e n a
konfesa	k o n f e s a
konj	k o n j
konja	k o n j a
konji	k o n j i
korko	k o r k o
kosta	k o s t a
koštahu	k o š t a h u
kozlič	k o z l i č
kralja	k r a l j a
krivahu	k r i v a h u
krivaša	k r i v a š a
krivit	k r i v i t
krokand	k r o k a n d
kruč	k r u č
kruh	k r u h
kruha	k r u h a
ku	k u
kučak	k u č a k
kučinu	k u č i n u
kučka	k u č k a
kum	k u m
kuma	k u m a
kumandza	k u m a n d z a
kumandzala	k u m a n d z a l a
kumandzaša	k u m a n d z a š a
kumanivahu	k u m a n i v a h u
kumba	k u m b a
kumbatit	k u m b a t i t
kumborta	k u m b o r t a
kume	k u m e
kumèdja	k u m è d j a
kumèdju	k u m è d j u
kumendza	k u m e n d z a
kumendzaju	k u m e n d z a j u
kumendzal	k u m e n d z a l
kunat	k u n a t
kundjend	k u n d j e n d
kundzolat	k u n d z o l a t
kuperti	k u p e r t i
kupi	k u p i
kupila	k u p i l a
kupiva	k u p i v a
kurcam	k u r c a m
kurčina	k u r č i n a
kurta	k u r t a
kvarandòt	k v a r a n d ò t
kvart	k v a r t
kvas	k v a s
kvaš	k v a š
kvinič	k v i n i č
la	l a
lačan	l a č a n
ladžermanija	l a d ž e r m a n i j a
laeroport	l a e r o p o r t
laje	l a j e
lalberg	l a l b e r g
lamerika	l a m e r i k a
lamèrika	l a m è r i k a
larusja	l a r u s j a
laustralija	l a u s t r a l i j a
leč	l e č
lejita	l e j i t a
ležahma	l e ž a h m a
ležaša	l e ž a š a
ličing	l i č i n g
liduj	l i d u j
likvor	l i k v o r
linea	l i n e a
linòv	l i n ò v
linuč	l i n u č
lip	l i p
lipa	l i p a
lipe	l i p e
lipi	l i p i
lipo	l i p o
lipu	l i p u
lisica	l i s i c a
lisice	l i s i c e
lisicu	l i s i c u
lištes	l i š t e s
lita	l i t a
litre	l i t r e
ljud	l j u d
ljuda	l j u d a
loku	l o k u
lor	l o r
lòt	l ò t
lu	l u
luji	l u j i
lukumun	l u k u m u n
lukvarandatre	l u k v a r a n d a t r e
lundana	l u n d a n a
lupuort	l u p u o r t
lurèndz	l u r è n d z
lusesandačing	l u s e s a n d a č i n g
lusesandasèj	l u s e s a n d a s è j
luštra	l u š t r a
m	m
ma	m a
mačalongu	m a č a l o n g u
magina	m a g i n a
magine	m a g i n e
maginu	m a g i n u
maginuacc	m a g i n u a c c
mahma	m a h m a
mahu	m a h u
maj	m a j
maju	m a j u
mala	m a l a
male	m a l e
mali	m a l i
malica	m a l i c a
malje	m a l j e
malocchj	m a l o c c h j
malomu	m a l o m u
mam	m a m
mama	m a m a
mamom	m a m o m
mamu	m a m u
mandanija	m a n d a n i j a
mandanu	m a n d a n u
manere	m a n e r e
mang	m a n g
mangaša	m a n g a š a
mangu	m a n g u
marilena	m a r i l e n a
maš	m a š
maša	m a š a
masarija	m a s a r i j a
masarije	m a s a r i j e
masariju	m a s a r i j u
maslina	m a s l i n a
masline	m a s l i n e
maslini	m a s l i n i
mašta	m a š t a
mat	m a t
matarudat	m a t a r u d a t
matre	m a t r e
mbača	m b a č a
mbilal	m b i l a l
mblad	m b l a d
mblade	m b l a d e
mblijaju	m b l i j a j u
mbresjunan	m b r e s j u n a n
mbreštivahu	m b r e š t i v a h u
mbreštivaša	m b r e š t i v a š a
me	m e
meča	m e č a
mečahu	m e č a h u
mečam	m e č a m
mečama	m e č a m a
mečaš	m e č a š
mečaša	m e č a š a
meče	m e č e
meču	m e č u
medik	m e d i k
medikal	m e d i k a l
mèdz	m è d z
mekanik	m e k a n i k
mekinj	m e k i n j
mekinje	m e k i n j e
men	m e n
mena	m e n a
mendrka	m e n d r k a
menom	m e n o m
mi	m i
mičicja	m i č i c j a
mičicji	m i č i c j i
mičicju	m i č i c j u
midaša	m i d a š a
mirit	m i r i t
misačin	m i s a č i n
misacina	m i s a c i n a
mišenja	m i š e n j a
miseria	m i s e r i a
misli	m i s l i
mislija	m i s l i j a
mislila	m i s l i l a
mista	m i s t a
mo	m o
mobahu	m o b a h u
mobaša	m o b a š a
moga	m o g a
mogl	m o g l
mogla	m o g l a
moj	m o j
moja	m o j a
moje	m o j e
mojom	m o j o m
moju	m o j u
mome	m o m e
momend	m o m e n d
momènd	m o m è n d
momi	m o m i
morahu	m o r a h u
moram	m o r a m
morama	m o r a m a
moraš	m o r a š
moraša	m o r a š a
more	m o r e
moru	m o r u
moždane	m o ž d a n e
moždani	m o ž d a n i
mrtav	m r t a v
mrzli	m r z l i
mu	m u
mučan	m u č a n
mutor	m u t o r
muž	m u ž
muža	m u ž a
n	n
na	n a
nabanu	n a b a n u
nabota	n a b o t a
nabra	n a b r a
nadahma	n a d a h m a
naduga	n a d u g a
nafačal	n a f a č a l
nafačivaju	n a f a č i v a j u
nahodahma	n a h o d a h m a
nahodaju	n a h o d a j u
nahodam	n a h o d a m
najija	n a j i j a
najila	n a j i l a
najist	n a j i s t
naka	n a k a
nakaka	n a k a k a
nakj	n a k j
nakoka	n a k o k a
nal	n a l
nala	n a l a
namagor	n a m a g o r
nami	n a m i
nanašu	n a n a š u
napija	n a p i j a
napila	n a p i l a
napošt	n a p o š t
napri	n a p r i
naprtija	n a p r t i j a
napunija	n a p u n i j a
napunila	n a p u n i l a
naš	n a š
nasa	n a s a
naša	n a š a
naše	n a š e
našga	n a š g a
našu	n a š u
nave	n a v e
naveče	n a v e č e
naza	n a z a
nažgal	n a ž g a l
nazjamu	n a z j a m u
nduneta	n d u n e t a
ndzakiva	n d z a k i v a
ndzan	n d z a n
ndžinjir	n d ž i n j i r
ndžinjira	n d ž i n j i r a
ne	n e
nebu	n e b u
neča	n e č a
nel	n e l
nelju	n e l j u
nenadahma	n e n a d a h m a
nenadam	n e n a d a m
nenadaš	n e n a d a š
nenadaša	n e n a d a š a
nga	n g a
ngacane	n g a c a n e
ngala	n g a l a
ngaliva	n g a l i v a
nganda	n g a n d a
ngargat	n g a r g a t
nhi	n h i
nihi	n i h i
nija	n i j a
nijaje	n i j a j e
nije	n i j e
nike	n i k e
niknija	n i k n i j a
nikor	n i k o r
nikromu	n i k r o m u
nima	n i m a
nimahma	n i m a h m a
nimahu	n i m a h u
nimaju	n i m a j u
nimaldže	n i m a l d ž e
nimam	n i m a m
nimaš	n i m a š
nimaša	n i m a š a
nis	n i s
nisa	n i s a
nišča	n i š č a
nisi	n i s i
nisma	n i s m a
nisu	n i s u
njega	n j e g a
njemu	n j e m u
njev	n j e v
njeva	n j e v a
njeve	n j e v e
njevga	n j e v g a
njevmu	n j e v m u
njevog	n j e v o g
njevoga	n j e v o g a
njevogu	n j e v o g u
njevu	n j e v u
njifog	n j i f o g
njifoga	n j i f o g a
njifoge	n j i f o g e
njifogu	n j i f o g u
njihi	n j i h i
njime	n j i m e
njimi	n j i m i
njiva	n j i v a
njivami	n j i v a m i
njizdu	n j i z d u
njoju	n j o j u
njom	n j o m
no	n o
nò	n ò
noča	n o č a
noču	n o č u
nogami	n o g a m i
noge	n o g e
nogu	n o g u
nomo	n o m o
nompl	n o m p l
nòna	n ò n a
nonda	n o n d a
nonde	n o n d e
nondeka	n o n d e k a
nondekaj	n o n d e k a j
nònu	n ò n u
nord	n o r d
normal	n o r m a l
nosahma	n o s a h m a
nosahu	n o s a h u
nosaša	n o s a š a
nosi	n o s i
nosim	n o s i m
nosiš	n o s i š
nosit	n o s i t
not	n o t
nov	n o v
nove	n o v e
novèmbr	n o v è m b r
nstvara	n s t v a r a
nu	n u
numahu	n u m a h u
numim	n u m i m
ŋgalala	ŋ g a l a l a
ŋgapa	ŋ g a p a
o	o
oč	o č
oča	o č a
očistila	o č i s t i l a
oda	o d a
odeka	o d e k a
odekaj	o d e k a j
oganj	o g a n j
oglav	o g l a v
ognja	o g n j a
okla	o k l a
okula	o k u l a
on	o n
ona	o n a
onamaka	o n a m a k a
one	o n e
onga	o n g a
onhi	o n h i
oni	o n i
onihi	o n i h i
onimi	o n i m i
onjitand	o n j i t a n d
ono	o n o
onodila	o n o d i l a
onoga	o n o g a
onoju	o n o j u
onomu	o n o m u
onu	o n u
opadva	o p a d v a
operaja	o p e r a j a
operaji	o p e r a j i
oprala	o p r a l a
or	o r
osami	o s a m i
osar	o s a r
ose	o s e
osta	o s t a
ostal	o s t a l
ostavahu	o s t a v a h u
ostavaš	o s t a v a š
otaja	o t a j a
otaje	o t a j e
otasu	o t a s u
otel	o t e l
otòbr	o t ò b r
ova	o v a
ovdan	o v d a n
ovdekaj	o v d e k a j
ove	o v e
ovga	o v g a
ovhi	o v h i
ovi	o v i
ovo	o v o
ovom	o v o m
ovu	o v u
pa	p a
padaju	p a d a j u
pak	p a k
paka	p a k a
pal	p a l
pala	p a l a
palaka	p a l a k a
palatu	p a l a t u
panaj	p a n a j
panunde	p a n u n d e
panundiva	p a n u n d i v a
paparola	p a p a r o l a
par	p a r
para	p a r a
parenda	p a r e n d a
parigi	p a r i g i
parikj	p a r i k j
parket	p a r k e t
parti	p a r t i
partu	p a r t u
paskvalina	p a s k v a l i n a
paštarele	p a š t a r e l e
paštarèle	p a š t a r è l e
pe	p e
pëke	p ë k e
penja	p e n j a
per	p e r
perdunat	p e r d u n a t
perfin	p e r f i n
però	p e r ò
pèrò	p è r ò
pez	p e z
pickat	p i c k a t
piljuh	p i l j u h
pilom	p i l o m
pilu	p i l u
pindže	p i n d ž e
ping	p i n g
pisana	p i s a n a
pištola	p i š t o l a
pita	p i t a
pital	p i t a l
pitala	p i t a l a
pitivat	p i t i v a t
pljeski	p l j e s k i
po	p o
poča	p o č a
počil	p o č i l
podne	p o d n e
poj	p o j
pojta	p o j t a
pojtasiga	p o j t a s i g a
pokj	p o k j
pol	p o l
pola	p o l a
polovcu	p o l o v c u
ponesaš	p o n e s a š
pong	p o n g
poni	p o n i
ponija	p o n i j a
ponil	p o n i l
ponit	p o n i t
pop	p o p
porca	p o r c a
poša	p o š a
posibilmènd	p o s i b i l m è n d
possibile	p o s s i b i l e
pòšt	p ò š t
postalja	p o s t a l j a
postalje	p o s t a l j e
postalju	p o s t a l j u
postole	p o s t o l e
potegnil	p o t e g n i l
potežahu	p o t e ž a h u
potipla	p o t i p l a
povida	p o v i d a
povidala	p o v i d a l a
povidat	p o v i d a t
povidivaju	p o v i d i v a j u
povidivam	p o v i d i v a m
povidivaša	p o v i d i v a š a
pozjamu	p o z j a m u
pozljamu	p o z l j a m u
praha	p r a h a
prasa	p r a s a
prasatu	p r a s a t u
prazna	p r a z n a
prenotat	p r e n o t a t
prije	p r i j e
prijedë	p r i j e d ë
prijeka	p r i j e k a
prim	p r i m
primitila	p r i m i t i l a
prisegla	p r i s e g l a
proda	p r o d a
profesor	p r o f e s o r
prohodahu	p r o h o d a h u
prohodaša	p r o h o d a š a
projahu	p r o j a h u
prokj	p r o k j
prol	p r o l
prola	p r o l a
proprja	p r o p r j a
prosi	p r o s i
prosil	p r o s i l
prosim	p r o s i m
prova	p r o v a
prvi	p r v i
puč	p u č
puh	p u h
pujal	p u j a l
pukla	p u k l a
pulman	p u l m a n
pulmana	p u l m a n a
puna	p u n a
punahma	p u n a h m a
punim	p u n i m
pur	p u r
purgatòrij	p u r g a t ò r i j
purka	p u r k a
pušaša	p u š a š a
pušat	p u š a t
put	p u t
puta	p u t a
putam	p u t a m
rabahu	r a b a h u
rabi	r a b i
rabit	r a b i t
rabu	r a b u
race	r a c e
rajana	r a j a n a
raje	r a j e
rak	r a k
raka	r a k a
rana	r a n a
randža	r a n d ž a
ranjata	r a n j a t a
ranjate	r a n j a t e
ranjatu	r a n j a t u
razbanu	r a z b a n u
razbija	r a z b i j a
razbil	r a z b i l
razbnoti	r a z b n o t i
razdilija	r a z d i l i j a
reč	r e č
reciju	r e c i j u
reka	r e k a
rekl	r e k l
rekla	r e k l a
remur	r e m u r
remure	r e m u r e
rena	r e n a
rennes	r e n n e s
rep	r e p
repata	r e p a t a
ricambj	r i c a m b j
riče	r i č e
riči	r i č i
rikambj	r i k a m b j
rikambja	r i k a m b j a
rike	r i k e
rikota	r i k o t a
rikote	r i k o t e
rikotu	r i k o t u
rinu	r i n u
ripozivat	r i p o z i v a t
rispunija	r i s p u n i j a
rispunit	r i s p u n i t
riva	r i v a
rivaju	r i v a j u
rival	r i v a l
rivala	r i v a l a
rivaša	r i v a š a
rivat	r i v a t
riviva	r i v i v a
rivivahma	r i v i v a h m a
rivivaju	r i v i v a j u
rivivam	r i v i v a m
rivivaša	r i v i v a š a
rivoplan	r i v o p l a n
roba	r o b a
robe	r o b e
robu	r o b u
romandz	r o m a n d z
ros	r o s
rosso	r o s s o
ručinikam	r u č i n i k a m
ručinikom	r u č i n i k o m
rukami	r u k a m i
rus	r u s
rusa	r u s a
russi	r u s s i
s	s
š	š
sa	s a
sakate	s a k a t e
saki	s a k i
šaku	š a k u
salutat	s a l u t a t
salutiva	s a l u t i v a
salutivahu	s a l u t i v a h u
sam	s a m
sama	s a m a
se	s e
seconda	s e c o n d a
sedža	s e d ž a
sedže	s e d ž e
segrèt	s e g r è t
seki	s e k i
semaj	s e m a j
semblič	s e m b l i č
sembličjot	s e m b l i č j o t
sendza	s e n d z a
sèp	s è p
servahu	s e r v a h u
servi	s e r v i
servicj	s e r v i c j
servit	s e r v i t
servitur	s e r v i t u r
serviture	s e r v i t u r e
sestra	s e s t r a
sestru	s e s t r u
seta	s e t a
setèmbr	s e t è m b r
setimane	s e t i m a n e
setimanu	s e t i m a n u
sfašat	s f a š a t
sfe	s f e
sfedni	s f e d n i
sfekarvu	s f e k a r v u
sfekra	s f e k r a
sfinje	s f i n j e
sfita	s f i t a
sfitu	s f i t u
sfunala	s f u n a l a
si	s i
sì	s ì
sidaša	s i d a š a
sija	s i j a
sikondan	s i k o n d a n
sima	s i m a
sin	s i n
sina	s i n a
sir	s i r
sit	s i t
škala	š k a l a
škale	š k a l e
skandza	s k a n d z a
skandzivahma	s k a n d z i v a h m a
škar	š k a r
škarami	š k a r a m i
škare	š k a r e
škatulica	š k a t u l i c a
skinija	s k i n i j a
skinil	s k i n i l
skinit	s k i n i t
skinjivahu	s k i n j i v a h u
skojatol	s k o j a t o l
skoknija	s k o k n i j a
skola	s k o l a
skuhal	s k u h a l
skulivaša	s k u l i v a š a
skumasu	s k u m a s u
skupa	s k u p a
skupila	s k u p i l a
škura	š k u r a
škure	š k u r e
skuzu	s k u z u
skvalja	s k v a l j a
slama	s l a m a
slušal	s l u š a l
slušat	s l u š a t
sma	s m a
šma	š m a
smih	s m i h
smijahu	s m i j a h u
smijaš	s m i j a š
smijaša	s m i j a š a
smijat	s m i j a t
so	s o
sola	s o l a
solda	s o l d a
soldata	s o l d a t a
soldate	s o l d a t e
soldi	s o l d i
sottoljә	s o t t o l j ә
spal	s p a l
spandza	s p a n d z a
sparetun	s p a r e t u n
spasa	s p a s a
spat	s p a t
spečalmènd	s p e č a l m è n d
sperandzju	s p e r a n d z j u
spida	s p i d a
spije	s p i j e
spisa	s p i s a
spodare	s p o d a r e
spodaru	s p o d a r u
sportiv	s p o r t i v
sprega	s p r e g a
spro	s p r o
sprobudžana	s p r o b u d ž a n a
sprtu	s p r t u
srca	s r c a
sta	s t a
štacijuna	š t a c i j u n a
stahma	s t a h m a
stahu	s t a h u
staja	s t a j a
stajala	s t a j a l a
stajaša	s t a j a š a
stal	s t a l
stala	s t a l a
stan	s t a n
štangiva	š t a n g i v a
štape	š t a p e
stara	s t a r a
stare	s t a r e
starihi	s t a r i h i
stat	s t a t
štip	š t i p
štisi	š t i s i
stistane	s t i s t a n e
što	š t o
stojahma	s t o j a h m a
stojahu	s t o j a h u
stojaša	s t o j a š a
stoji	s t o j i
stojim	s t o j i m
stojiš	s t o j i š
stoju	s t o j u
štokiva	š t o k i v a
štokivam	š t o k i v a m
štokodi	š t o k o d i
storcu	s t o r c u
strašaša	s t r a š a š a
straši	s t r a š i
štrega	š t r e g a
strniš	s t r n i š
strofinač	s t r o f i n a č
štufa	š t u f a
štufe	š t u f e
stvara	s t v a r a
stvare	s t v a r e
stvari	s t v a r i
stvarice	s t v a r i c e
stvaro	s t v a r o
stvaru	s t v a r u
su	s u
subita	s u b i t a
sučediva	s u č e d i v a
sučedival	s u č e d i v a l
sufite	s u f i t e
sufitu	s u f i t u
šume	š u m e
sundza	s u n d z a
surčiva	s u r č i v a
surčivahu	s u r č i v a h u
surčivaju	s u r č i v a j u
surčivaša	s u r č i v a š a
šurjak	š u r j a k
surti	s u r t i
surtija	s u r t i j a
surtila	s u r t i l a
surtivaša	s u r t i v a š a
šuši	š u š i
šušit	š u š i t
šušnja	š u š n j a
ta	t a
taka	t a k a
taksi	t a k s i
tama	t a m a
tamadol	t a m a d o l
tang	t a n g
tata	t a t a
tatom	t a t o m
tatu	t a t u
taxi	t a x i
te	t e
teb	t e b
teba	t e b a
tebom	t e b o m
teč	t e č
teča	t e č a
tedeska	t e d e s k a
teg	t e g
tega	t e g a
tegič	t e g i č
teka	t e k a
tekl	t e k l
teknik	t e k n i k
telefunatu	t e l e f u n a t u
telefuniva	t e l e f u n i v a
telefunivam	t e l e f u n i v a m
telič	t e l i č
temborala	t e m b o r a l a
tepli	t e p l i
termulu	t e r m u l u
teta	t e t a
težak	t e ž a k
ti	t i
tija	t i j a
tijahu	t i j a h u
tir	t i r
tiraj	t i r a j
tjend	t j e n d
to	t o
toce	t o c e
tòk	t ò k
toni	t o n i
tonin	t o n i n
torko	t o r k o
tornad	t o r n a d
totekaj	t o t e k a j
tovar	t o v a r
tovara	t o v a r a
tovarom	t o v a r o m
tovaru	t o v a r u
tr	t r
tra	t r a
trače	t r a č e
tramite	t r a m i t e
tranj	t r a n j
trapit	t r a p i t
trapita	t r a p i t a
trapite	t r a p i t e
trator	t r a t o r
tratora	t r a t o r a
tren	t r e n
trèn	t r è n
trèna	t r è n a
trgaša	t r g a š a
trgat	t r g a t
tri	t r i
tu	t u
tuba	t u b a
tuculala	t u c u l a l a
tuna	t u n a
tunimi	t u n i m i
tusti	t u s t i
tut	t u t
tvoga	t v o g a
tvoj	t v o j
tvoja	t v o j a
tvorija	t v o r i j a
tvorivaša	t v o r i v a š a
u	u
ubija	u b i j a
ubil	u b i l
ubost	u b o s t
učer	u č e r
uhitaša	u h i t a š a
uhitija	u h i t i j a
ukj	u k j
ulist	u l i s t
uliz	u l i z
uliza	u l i z a
ulizla	u l i z l a
ulj	u l j
ulja	u l j a
umbiram	u m b i r a m
umbra	u m b r a
umirahu	u m i r a h u
undra	u n d r a
untra	u n t r a
unutra	u n u t r a
upijahu	u p i j a h u
upijaša	u p i j a š a
upijat	u p i j a t
ura	u r a
ure	u r e
urekla	u r e k l a
uri	u r i
usa	u s a
uša	u š a
ušl	u š l
usri	u s r i
usta	u s t a
ustal	u s t a l
ustan	u s t a n
ustrašila	u s t r a š i l a
ustri	u s t r i
ustrid	u s t r i d
utra	u t r a
uzandza	u z a n d z a
va	v a
vabene	v a b e n e
vabuon	v a b u o n
vadu	v a d u
vaka	v a k a
vakoka	v a k o k a
vakoma	v a k o m a
vami	v a m i
vamima	v a m i m a
vamita	v a m i t a
vamivahu	v a m i v a h u
vamivam	v a m i v a m
vamivaš	v a m i v a š
van	v a n
vana	v a n a
varan	v a r a n
varekine	v a r e k i n e
vasa	v a s a
vaz	v a z
vaza	v a z a
vazal	v a z a l
vazala	v a z a l a
vaze	v a z e
vazet	v a z e t
ve	v e
več	v e č
veča	v e č a
večaru	v e č a r u
velena	v e l e n a
velike	v e l i k e
velke	v e l k e
velki	v e l k i
velkomu	v e l k o m u
velku	v e l k u
veramènd	v e r a m è n d
verjahu	v e r j a h u
verona	v e r o n a
vèrsa	v è r s a
veza	v e z a
vezal	v e z a l
vezala	v e z a l a
vga	v g a
vi	v i
vičina	v i č i n a
vičine	v i č i n e
vičinivahu	v i č i n i v a h u
vičinivaša	v i č i n i v a š a
vid	v i d
vidahma	v i d a h m a
vidar	v i d a r
vidaša	v i d a š a
vidi	v i d i
vidija	v i d i j a
vidil	v i d i l
vidila	v i d i l a
vidim	v i d i m
vidiš	v i d i š
vidu	v i d u
vile	v i l e
vilja	v i l j a
vilje	v i l j e
vina	v i n a
vind	v i n d
vindikvatr	v i n d i k v a t r
visoka	v i s o k a
vištica	v i š t i c a
vištici	v i š t i c i
vit	v i t
vitar	v i t a r
viticu	v i t i c u
vlasa	v l a s a
vmi	v m i
voda	v o d a
vode	v o d e
vodu	v o d u
voo	v o o
vote	v o t e
votu	v o t u
vr	v r
vračam	v r a č a m
vračaš	v r a č a š
vračaša	v r a č a š a
vrat	v r a t
vrata	v r a t a
vrč	v r č
vrga	v r g a
vrima	v r i m a
vrita	v r i t a
vrl	v r l
vrla	v r l a
vrni	v r n i
vrnija	v r n i j a
vrnil	v r n i l
vrnila	v r n i l a
vrnisa	v r n i s a
vrz	v r z
vrzitamu	v r z i t a m u
vuču	v u č u
vuda	v u d a
vude	v u d e
vuk	v u k
vuka	v u k a
za	z a
zabritana	z a b r i t a n a
zagrača	z a g r a č a
zagračivaša	z a g r a č i v a š a
zaorat	z a o r a t
zateka	z a t e k a
zbalja	z b a l j a
zbatahu	z b a t a h u
zbatat	z b a t a t
zbaučane	z b a u č a n e
zbima	z b i m a
zbrnija	z b r n i j a
zdola	z d o l a
zdrave	z d r a v e
zdvigni	z d v i g n i
zdvignija	z d v i g n i j a
zec	z e c
žedža	ž e d ž a
zelenu	z e l e n u
željud	ž e l j u d
željuda	ž e l j u d a
žena	ž e n a
žene	ž e n e
ženjahu	ž e n j a h u
ženu	ž e n u
zgora	z g o r a
zgori	z g o r i
zgorit	z g o r i t
zgoru	z g o r u
zgoruzdolu	z g o r u z d o l u
zgubija	z g u b i j a
zima	z i m a
žita	ž i t a
živahma	ž i v a h m a
živahu	ž i v a h u
živaša	ž i v a š a
živija	ž i v i j a
zlo	z l o
znadaša	z n a d a š a
znam	z n a m
znaš	z n a š
znat	z n a t
znesivaju	z n e s i v a j u
zova	z o v a
zovahu	z o v a h u
zovaša	z o v a š a
zovu	z o v u
zuba	z u b a
zverniva	z v e r n i v a
